XXXXXXXXXXXXXXXXXXXXXXXXXXXXXXXXXXXXXXXXXXXXXXXXXXXXXXXXXXXXXXXXXXXXXXXXXXXXXXXXXXXXXXXXXXXXXXXXXXXXX
P         X X             X   X   X       X               X             X     X     X       X       X
XXXXX XXX X X XXXXXXX XXX X X X X XXXXX X X XXXXXXXXXXXXX X X XXXXXXXXX XXX X X X XXX XXXXX X XXX X X
X     X     X   X   X X   X X   X       X X     X     X   X X   X   X   X   X X X     X   X   X   X X
X XXXXXXXXX XXX XXX X XXX X XXXXX XXXXXXXXXXXXX XXX XXX XXX XXX X X X XXX XXXXX XXXXXXXXX XXXXX XXX X
X X       X X       X   X X X     X           X   X   X   X X   X X X X     X   X         X   X X   X
X X XXXXX XXX XXXXXXXXX X X X XXXXX XXXXXXXXX XXX XXX XXX X X XXX XXX X XXX X XXXXXXX X X XXX X X XXX
X X   X X     X X     X X   X X   X     X   X     X     X X X X   X   X X X   X     X X X     X X   X
X XXX X XXXXXXX X XXX X XXXXXXX X XXXXX X X XXXXXXX XXX X XXX X X X XXX X XXXXXXX X XXX XXXXX X XXXXX
X         X     X X     X       X       X X       X   X X   X X X X X     X       X     X   X X     X
X XXXXXXX XXXXX X X XXXXX XXXXXXXXXXXXXXX XXXXX X X X X XXX X X X X XXXXX X XXXXXXXXX XXX X XXXXXXX X
X X   X         X X X     X             X   X X X X X X   X X X X X   X X X X       X X   X     X   X
X X X XXXXXXXXXXX X X XXXXX X XXX XXXXX XXX X X XXX X X XXX X X X XXX X X X XXXXX XXX X XXXXXXX X XXX
X X X X   X       X X X     X X   X   X   X   X     X X X   X X X   X X X X X   X   X X X   X   X   X
XXX X X X X XXXXXXX X XXXXX X XXX X X X XXXXX XXXXXXX XXX XXX XXXXX X X X X X X XXX X X X XXX XXXXX X
X   X   X   X     X X X   X X   X X X X X   X X X     X   X   X     X X X   X X   X X X X           X
X XXXXXXXXXXXXX X X X X X X XXX XXX X XXX X X X X XXXXX XXXXX X X XXX X X XXX XXX X X X XXXXXXXXXXX X
X   X           X X X   X X   X     X     X     X             X X X   X   X   X   X   X X   X       X
X X X XXXXXXXXXXXXX XXXXX XXX XXXXXXXXXXXXXXXXXXXXXXXXXXXXXXXXX XXX XXXXXXX XXX XXXXXXX X X X XXXXXXX
X X X           X   X   X   X X   X   X   X   X     X       X X     X       X X X     X   X X X     X
X X X XXXXXXXXX X XXX X XXX X X X X X X X XXX X XXX X XXXXX X X XXXXX X XXXXX X XXX X X XXX X X X XXX
X X X   X     X   X   X X X X   X   X   X     X X X     X   X X X   X X   X   X     X X X   X X X   X
X X XXX X XXXXXXX X XXX X X XXXXXXXXXXXXX XXXXX X XXXXXXX XXX X X X XXXXX X XXXXXXXXX XXX XXX XXXXX X
X X X     X     X   X X   X             X X     X X       X   X X X   X   X         X     X   X     X
X X XXXXXXX XXX XXXXX X XXXXXXXXXXX XXX XXX XXXXX X XXXXXXX X X X XXX X XXX X XXXXX XXXXXXX XXX XXX X
X X       X   X   X     X     X   X   X X   X X   X     X   X     X     X X X     X X     X X   X   X
XXXXX XXX XXX XXX X XXXXX XXX X X XXXXX X XXX X X XXXXX XXXXXXXXXXXXXXXXX X XXXXX X XXX X X XXX X XXX
X   X   X   X X X X   X     X X X       X X     X     X       X     X     X X   X X   X X X   X X   X
X X XXXXXXX X X X X XXX XXXXX X XXXXXXX X X XXXXXXX XXXXXXXXX X XXX XXXXX X X X X XXX X XXXXX X XXXXX
X X   X     X   X X X   X X   X       X X X     X X       X X     X     X X X X X X   X     X X     X
X XXX X XXX XXX X XXX XXX X XXXXXXXXX XXX XXXXX X XXXXX X X XXXXXXXXXXX X X X XXX X XXXXX XXX XXXXX X
X   X   X     X X   X X   X   X     X   X   X   X   X   X   X           X X   X   X     X X   X     X
X X XXXXX XXXXX XXX X X X XXX X XXX XXX XXX X XXXXX X XXX XXX XXXXXXXXXXX XXX X X XXXXX X X XXX XXXXX
X X   X     X   X   X X X   X   X X   X   X X X     X X   X   X       X       X X X   X   X X       X
X XXX X XXXXX XXX X X X X XXXXX X XXX X XXX X XXX X X X XXX XXXXXXX X XXXXXXX X XXX X XXX X X XXXXX X
X   X X   X   X X X X X X X   X   X   X     X X   X X X X X   X   X X       X X X   X X   X X X     X
XXX X XXX X XXX X X X XXX X X XXXXX X XXXXXXX X XXXXX X X XXX X X X XXXXXXX XXX X XXX X XXX X X XXX X
X   X   X X X   X X X X   X X     X X X     X X X   X X     X   X X       X   X X   X X X X X X X   X
X XXXXX XXX X X X XXX X X X XXXXX X X XXX X X X X X X XXXXX XXXXX X XXXXX XXX X X XXX X X X X X X XXX
X     X X   X X X X   X X X   X     X   X X X   X X   X   X X     X X   X X     X X   X   X X X X   X
XXXXXXX X XXXXX X X XXX X XXX XXXXXXXXX X X X XXX XXXXX XXX X XXXXX X X X X XXXXX X XXXXXXX X X XXX X
X       X X   X X X X   X X X         X   X X X   X   X     X X   X X X X X X     X   X     X X   X X
X XXXXXXX X X X X X X XXX X XXXXXXXXX XXXXX XXX X X X X XXXXX X XXX X X X X X XXXXXXX X XXXXXXX X X X
X       X   X   X X   X X   X   X X   X   X     X X X X   X   X X   X X X X X X X     X X     X X X X
X XXXXX XXXXXXX X XXXXX XXX X X X X XXX XXXXXXX XXX X XXXXX XXX X XXXXX X XXX X X XXXXX X XXX XXX X X
X     X         X   X     X X X   X X         X X   X X     X   X X     X     X X       X   X     X X
XXXXX XXXXXXXXXXX X XXXXX X X XXX X X XXXXX X X X XXX X XXXXX XXX X X XXXXXXXXX XXXXXXXXXXX XXXXXXXXX
X   X   X   X     X   X   X   X X X X X     X X X   X   X       X X X X         X           X       X
X X XXX XXX X XXXXXXX X X XXXXX X X XXX XXXXXXX XXX XXXXXXXXX X X XXX X XXX XXXXX XXXXXXX XXX XXXXX X
X X   X     X       X X X       X X   X         X X   X     X X X   X X   X     X       X       X   X
XXXXX XXXXX XXXXXXX X X XXXXXXXXX XXX XXXXXXXXX X XXX X XXX XXX XXX X XXX XXXXX XXXXXXX XXXXXXXXX X X
X   X     X   X   X X   X         X X         X   X X     X   X     X       X   X     X X   X   X X X
X X X XXX XXX XXX X XXXXX XXXXXXXXX XXXXXXXXX XXX X XXXXX XXX X XXXXXXXXX XXX XXX XXX X X XXX X X X X
X X X X X X   X   X   X   X     X           X X   X X   X X   X   X     X X   X   X X   X   X X   X X
X X X X X X XXX XXXXX X XXX XXX XXXXXXX X XXX X XXX X X X X XXXXX XXX X XXX XXX XXX XXXXXXX X XXXXX X
X X   X   X X       X X     X X     X   X X   X X   X X X X X   X     X   X   X X   X       X     X X
X XXXXXXX X XXXXX X X XXXXXXX XXXXX X XXX X XXX XXX X X XXX X X XXXXXXXXX X X X X X X XXXXX XXXXX X X
X X     X X       X X           X     X   X   X X   X X X   X X   X     X X X   X X   X   X X X   X X
X X XXX X XXXXXXXXX X X XXXXX XXX XXXXXXXXX X X X XXX X X XXX XXX X XXX X X XXXXX XXXXX XXX X X XXX X
X X X X X         X X X X   X X   X       X X X   X   X   X     X X   X   X       X     X   X X X   X
X X X X X XXXXXXXXX X X X X XXX XXX XXXXX XXX XXX X XXXXXXX XXXXX XXX XXXXXXXXXXXXX XXX X XXX X XXXXX
X     X X X   X     X X X X X   X   X   X     X   X   X   X   X   X   X         X X X X   X   X     X
XXXXXXX XXX X X XXXXX XXX X X XXX XXX X XXXXX XXXXXXX X X XXX X X X XXXXXXX XXX X X X XXXXX X XXXXX X
X     X X   X   X   X     X   X X   X X       X     X   X   X X X X   X     X X X X         X     X X
X XXX X X XXXXXXX X XXXXXXXXXXX XXX X XXXXXXXXX XXX XXXXXXX X X X XXX X XXXXX X X XXXXX XXXXX XXXXX X
X   X   X X   X   X   X           X X X   X     X X X       X X X X X   X       X   X   X   X X     X
XXX XXX X XXX X XXX X X XXXXXXXXX X X XXX X XXXXX X X XXXXXXXXX X X XXXXX XXXXXXX X X XXX X XXX XXX X
X   X   X   X X   X X   X   X   X X X   X X   X   X   X         X   X   X X   X   X   X   X   X   X X
X XXX XXXXX X XXX X XXXXX XXX X X X XXX X XXX X X XXXXXXX XXXXXXXXX X XXX XXX X XXXXXXX XXXXX XXX X X
X X     X X X     X X     X   X   X X       X X X         X     X     X   X   X       X   X   X   X X
X XXXXX X X XXXXXXX X X XXX XXXXXXX XXXXXXXXXXX XXXXXXX XXX XXX XXXXXXX XXX X XXX XXXXXXX X XXX XXX X
X   X X   X         X X X   X     X   X       X X X   X     X X         X   X X   X       X     X X X
XXX X X XXXXXXXXXXXXX XXX XXXXX XXXXX X XXXXX X X X X XXXXXXX XXXXXXXXXXXXX XXX XXX XXXXXXXXXXXXX X X
X   X X X                 X     X     X X X   X X X X   X   X               X     X   X         X   X
X XXX X X XXXXXXXXXXXXXXXXX X X X XXXXX X X XXX X X X X X X XXX XXXXXXX XXX X XXXXXXX X XXXXXXX X XXX
X   X   X X     X   X       X X X     X X X     X   X X X X   X X     X X   X X     X X X X     X   X
XXX XXXXX XXX X X X XXX XXXXX X XXXXX X X XXXXXXXXXXX X X XXX X X XXX X XXXXX X XXX X X X X XXXXXXXXX
X   X     X   X   X   X   X   X     X   X       X     X   X X X   X   X       X X   X   X X     X   X
X X X XXXXX XXXXXXXXX XXX X XXXXXXX XXXXXXX XXX X XXXXXXXXX X XXXXX XXXXXXX XXX X XXX XXX XXXXX X X X
X X X X     X   X     X   X X   X   X       X X   X     X     X   X X     X   X X X   X       X X X X
X XXX XXX X X X X XXXXXXXXX X X X XXXXX XXXXX XXX X XXX XXX XXX X XXX XXX XXXXX X X XXX XXXXX X X X X
X   X   X X X X X           X X X X     X   X   X X   X   X   X X     X X       X X   X X     X   X X
X X XXX XXX XXX XXXXXXXXXXXXX X X X XXX X X X X X XXX XXX XXX X XXXXXXX XXXXXXXXX XXX XXX XXX XXXXX X
X X   X X   X   X           X X   X X   X X X X     X X X   X   X X             X X X X   X X     X X
X XXX X X XXX X X XXX XXXXX X XXXXX XXXXX X XXXXXXXXX X XXX XXXXX X XXXXX X XXXXX X X X XXX XXXXX X X
X   X X   X   X X X X X   X X   X X   X   X         X   X   X           X X X   X X     X       X X X
XXX X XXXXX XXXXX X X X X X XXX X X X X XXXXXXXXXXX XXX X X XXXXXXXXXXX X XXX X X XXXXXXX XXXXX X X X
X X X         X   X X X X   X   X X X   X X       X     X X X     X   X X     X X   X   X   X   X X X
X X XXXXXXXXX X XXX X XXXXXXX XXX X XXXXX X X XXXXXXXXXXX XXX XXX XXX X XXXXXXX XXX X XXX X X XXX X X
X   X       X X     X X       X   X     X   X X           X   X   X   X     X X     X   X X X X   X X
X XXX XXXXX X XXXXX X X XXXXXXXXX XXXXX X XXX X XXXXXXXXX X XXX XXX X XXXXX X XXXXXXX X X X XXX XXX X
X   X X     X   X   X   X       X X     X   X X   X       X X   X   X     X     X X   X   X       X X
XXX X X XXXXX X X XXXXXXXXXXX X X X XXXXXXXXX XXX XXXXXXXXX X XXX XXX XXXXXXXXX X X XXXXXXXXX XXXXX X
X   X X X   X X X           X X X     X   X   X X           X X     X X         X   X       X X     X
X XXX XXX X X X XXXXXXXXXXX X X XXXXX X X X X X XXXXXXXXXXXXX X XXX X X XXXXXXXXXXX X XXXXX X X XXXXX
X X     X X   X X         X   X     X   X   X   X     X       X   X X X X     X   X X   X   X X     X
X XXXXX X XXXXX X X XXXXXXXXXXXXXXX XXXXXXXXXXX X XXX X XXXXXXXXX X XXX X XXX X X XXXXX XXX X XXXXX X
X X   X X   X   X X       X       X     X     X X X X X X X   X   X     X   X   X     X   X X X     X
X X X X XXX XXXXX XXXXXXX X XXXXX XXXXX X XXX XXX X X X X X X X XXXXXXXXXXX XXXXXXXXX XXX X XXX XXX X
X   X     X             X       X         X       X     X   X               X             X     X   K
XXXXXXXXXXXXXXXXXXXXXXXXXXXXXXXXXXXXXXXXXXXXXXXXXXXXXXXXXXXXXXXXXXXXXXXXXXXXXXXXXXXXXXXXXXXXXXXXXXXXX
