XXXXXXX
P     X
X XXX X
X X   X
XXX XXX
X     K
XXXXXXX
