XXXXXXXXXXXXXXXXXXXXXXXXXXXXXXXXXXXXXXXXXXXXXXXXXXXXXXXXXXXXX
X X         X                 X         X     X   X         X
X X XXX XXX X XXXXXXXXX XXXXXXX XXXXX XXX X X X X X X XXXXX X
X   X X   X X X     X   X   X       X X   X X X X   X     X X
X XXX XXX X X XXX X X XXX X X XXXXXXX X XXX X XXX XXXXXXX X X
X       X X X   X X X   X X   X     X     X X   X       X X X
XXXXX XXX X XXX X X XXX X XXXXX XXX XXXXXXX XXX XXXXXXX X XXX
X   X X   X   X   X   X X X   X   X   X     X X X       X   X
X X XXX XXXXX XXXXXXX X X X X XXX XXX X XXXXX X XXX XXXXXXX X
X X     X X         X X   X X   X X   X     X X   X X X     X
X XXXXXXX X XXXXXXXXX XXXXXXX XXX X XXXXXXX X XXX X X X XXX X
X X     X   X   X     X   X   X   X X       X X   X   X X   X
X X XXX XXXXX X X XXXXX X X XXX XXX X X XXXXX X XXXXX X XXXXX
X X X X X     X   X     X X   X X X X X   X   X     X X     X
X X X X X XXXXXXXXXXX XXX XXX X X X X XXX XXX XXXXX X XXXXX X
X     X X X   X     X X X X   X X X X   X   X     X X     X X
XXXXXXX X X X X XXX X X X X X X X X XXX XXX XXXXX X XXXXXXX X
X       X   X X X   X X   X X X X     X X   X     X X     X X
X XXXXX XXXXX X X XXX XXX X X X XXXXX X X XXX XXXXX X XXX X X
X X       X   X X   X   X   X X   X   X X X   X   X X   X   X
X XXXXXXXXX XXX XXX XXX XXXXX XXX X XXXXX X XXX X X XXX XXX X
X           X   X   X   X   X   X X   X   X   X X X   X   X X
X XXXXXXXXXXXXX X XXX XXX XXX XXX XXX X XXXXX X X XXX XXX X X
X X           X X     X       X   X X X     X   X   X     X X
X X XXXXXXX X X XXXXX XXXXX XXX XXX X XXXXX X XXXXX XXXXXXX X
X X     X   X X X     X   X X   X   X X   X X     X     X   X
X XXXXXXX XXX X XXX XXX X X X XXX X X X X X XXXXX XXX XXX XXX
X       X   X X   X X X X X X X   X X   X X   X     X   X   X
XXXXXXX XXX X XXX X X X X XXX X XXXXXXXXX XXX XXXXXXXXX XXX X
P   X       X     X   X X     X         X   X X       X     X
X X XXXXXXXXXXX XXXXXXX XXXXXXXXXXX XXX XXX X X XXXXX XXXXXXX
X X       X     X     X X     X   X   X       X X   X X     K
X XXXXXXX XXXXXXX XXX X X XXX X X XXX XXXXXXXXX XXX X X XXX X
X       X   X     X     X X X   X X         X       X X   X X
X XXXXX XXX X XXXXX XXXXX X XXXXX XXXXXXXXXXX XXXXXXX X XXX X
X   X   X X   X   X   X   X X     X     X     X       X X   X
XXXXX XXX XXXXX XXXXX X XXX X XXX X XXX X XXXXX XXXXXXX X XXX
X     X       X     X X     X X   X   X   X   X X       X   X
X XXXXX XXX XXX X X X XXXXX X XXXXXXX XXXXX X X X XXXXXXXXX X
X X   X   X   X X X X     X X         X     X X X X   X     X
X X X XXX XXX X X XXX XXXXX XXXXXXXXXXX XXX X X X X XXX XXX X
X X X   X X   X X X   X   X   X       X   X X X   X   X X X X
X XXXXX X X XXX X X XXX X XXX X XXXXX XXXXX XXXXXXX X X X X X
X     X   X X   X   X   X   X X X   X     X       X X X X   X
X XXX XXXXX X XXXXXXX XXX XXX X X X XXXXX XXX X X XXX X XXX X
X X   X   X     X     X X     X X X X   X   X X X     X   X X
XXX X X X XXXXX X XXXXX XXXXXXX X X X X XXX X X XXXXX XXX XXX
X   X X X     X X       X         X X X     X X   X X X X   X
X XXXXX XXXXX XXXXXXXXX X XXXXXXXXX X XXXXXXX XXX X X X XXX X
X     X     X     X   X X   X       X X   X     X X   X   X X
X XXX XXXXX XXXXX X X X XXX X XXXXXXX X XXX XXXXX X XXX XXX X
X X   X     X   X   X   X   X X       X       X   X     X   X
X X X X XXXXXXX XXXXXXXXXXXXX XXX XXXXXXXXXXXXX XXX XXXXX X X
X X X X           X         X   X     X         X   X     X X
XXX X XXXXXXXXXXX XXX XXXXX XXX XXXXX X XXXXXXXXX XXX XXXXXXX
X   X X   X       X   X   X   X   X X   X       X X   X     X
X XXX X XXX XXXXXXX XXXXX XXX XXX X XXXXX XXXXXXX X XXX XXX X
X   X   X   X     X X       X     X       X       X   X   X X
X X XXXXX XXXXX X X X X XXXXXXXXXXX XXXXXXX XXXXXXXXX XXX XXX
X X             X   X X                             X       X
XXXXXXXXXXXXXXXXXXXXXXXXXXXXXXXXXXXXXXXXXXXXXXXXXXXXXXXXXXXXX
