XXXXXXXXXXXXXXXXXXXXXXXXXXXXXXXXXXXXXXXXX
X X       X   X     X     X       X     X
X X XXXXX X X X XXX X X XXX X XXXXX X XXX
X   X   X   X     X X X     X       X   X
X XXX XXXXXXXXXXXXX X XXXXX XXXXXXXXXXX X
X X     X       X   X X   X X       X   X
X XXXXX X X XXXXX XXXXX X XXX XXXXX X X X
X X   X X X     X     X X   X     X X X X
X X X X X XXXXX XXXXXXX XXX X XXX X X X X
X X X   X X   X   X     X   X   X X   X X
X X XXXXX X X X X X X XXX XXX XXX XXXXX X
X X   X   X X X X X X X X X   X   X X   X
X XXX X XXX X X X X X X X XXXXX XXX X XXX
X X   X   X X X X X X X X     X X       X
X X XXXXX X X X XXX X X XXXXX X XXXXXXXXX
X X   X   X X X     X X     X X     X   X
X XXX X XXXXX XXXXXXX X XXX X XXX X X X X
X   X X           X X X X   X   X X   X X
XXX X XXX XXXXXXX X X X X XXXXX XXXXXXX X
P X X     X   X   X X X X   X   X   X   X
X X XXX XXX X XXX X X X XXXXX XXX X X X X
X X   X X   X   X   X X X   X X   X   X K
X XXX XXX XXXXX XXXXX X X X X X X XXXXX X
X   X   X X   X X   X X   X   X X     X X
XXX XXX X X X X X X X X XXXXXXX XXXXX XXX
X   X   X X X X   X   X     X X   X X   X
X X X XXX X X XXXXXXXXXXXXX X XXX X XXX X
X X X   X X X   X         X X         X X
X X XXX X X X XXX X XXXXXXX X XXXXXXXXX X
X X   X   X X     X X     X X X       X X
X XXXXXXXXX XXXXXXX X XXX X X X XXXXX X X
X         X X     X X   X   X X     X   X
XXXXXXXXX X X XXX X XXX XXXXXXXXXXX XXX X
X         X   X X X     X           X   X
X XXXXXXX XXXXX X XXXXXXXXXXX XXXXXXX XXX
X X     X X     X X     X   X     X   X X
X X XXX X XXXXX X XXX X X X XXXXX X XXX X
X X   X X       X X   X   X     X X X   X
X XXX X XXXXXXXXX X XXXXXXXXXXX X X XXX X
X     X             X             X     X
XXXXXXXXXXXXXXXXXXXXXXXXXXXXXXXXXXXXXXXXX
